riskType,id,openDate,closeDate,optionSymbol,symbol,fillPrice,initialAsk,maxPrice,preTradeBalance,tradeAmount,pl,postTradeBalance,lastPrice,finalAmount,status,quantity,trim1Price,trim1Quantity,trim1PriceFinal,trim2Price,trim2Quantity,trim2PriceFinal,trimStatus,stopPriceFinal
Lotto,796970506624367,2024-02-01,2024-02-01 03:00:00,SPY240201C0036100,SPY,0.16,0.16,0.27,4000.0,160.0,233,4233.0,0.0,0.0,5,10,0.27,5,0.27,0.0,0,0.0,1,0.27
Lotto,697155202894214,2024-02-02,2024-02-02 04:00:00,LUV240202C0033000,LUV,1.89,1.89,2.22,4233.0,189.0,-189,4044.0,0.0,0.0,5,1,3.21,1,0.0,0.0,0,0.0,0,0.0
Base,146134383987820,2024-02-05,2024-02-05 07:00:00,MCD240205C0031300,MCD,0.34,0.34,0.99,4044.0,170.0,337,4381.0,0.0,0.0,5,5,0.44,3,0.44,0.58,2,0.58,2,0.58
Vision,396907689369937,2024-02-06,2024-02-06 06:00:00,XOM240206C0033400,XOM,1.42,1.42,2.82,4381.0,142.0,173,4554.0,0.0,0.0,5,1,0.0,0,0.0,0.0,0,0.0,0,1.62
Lotto,126472439470938,2024-02-07,2024-02-07 07:00:00,SPY231117C0039300,SPY,1.76,1.76,1.88,4554.0,176.0,215,4769.0,0.0,0.0,5,1,2.99,1,0.0,0.0,0,0.0,0,0.0
Lotto,746049591196697,2024-02-08,2024-02-08 06:00:00,XOM240208C0047800,XOM,1.47,1.47,3.68,4769.0,147.0,165,4934.0,0.0,0.0,5,1,2.5,1,2.5,0.0,0,0.0,1,2.5
Base,283155260938773,2024-02-09,2024-02-09 03:00:00,SPY231125P0034000,SPY,0.37,0.37,0.55,4934.0,222.0,333,5267.0,0.0,0.0,5,6,0.48,3,0.48,0.63,3,0.0,1,0.48
Lotto,528043706331138,2024-02-12,2024-02-12 05:00:00,IWM240212P0047800,IWM,0.7,0.7,1.16,5267.0,210.0,365,5632.0,0.0,0.0,5,3,1.19,2,0.0,0.0,0,0.0,0,0.0
Lotto,475545787581201,2024-02-13,2024-02-13 03:00:00,AMD240213C0053800,AMD,1.38,1.38,2.91,5632.0,276.0,311,5943.0,0.0,0.0,5,2,2.35,1,2.35,0.0,0,0.0,1,2.35
Lotto,266298649802674,2024-02-14,2024-02-14 04:00:00,AMD240214C0050500,AMD,0.61,0.61,1.61,5943.0,244.0,-244,5699.0,0.0,0.0,5,4,1.04,2,1.04,0.0,0,0.0,1,1.04
Base,246162979553161,2024-02-15,2024-02-15 01:00:00,BAC240215P0038400,BAC,0.73,0.73,1.9,5699.0,219.0,433,6132.0,0.0,0.0,5,3,0.95,2,0.95,1.24,1,1.24,2,1.24
Base,519093635205936,2024-02-16,2024-02-16 05:00:00,SPY231217P0046200,SPY,0.51,0.51,0.96,6132.0,255.0,260,6392.0,0.0,0.0,5,5,0.66,3,0.66,0.87,2,0.87,2,0.87
Vision,540559473940191,2024-02-19,2024-02-19 02:00:00,SPY231222C0047000,SPY,0.71,0.71,0.76,6392.0,284.0,534,6926.0,0.0,0.0,5,4,0.0,0,0.0,0.0,0,0.0,0,0.59
Lotto,832814013649955,2024-02-20,2024-02-20 07:00:00,SPY231227P0055800,SPY,0.78,0.78,1.52,6926.0,312.0,508,7434.0,0.0,0.0,5,4,1.33,2,1.33,0.0,0,0.0,1,1.33
Vision,182679349775129,2024-02-21,2024-02-21 04:00:00,BAC240221C0056700,BAC,0.83,0.83,0.93,7434.0,332.0,332,7766.0,0.0,0.0,5,4,0.0,0,0.0,0.0,0,0.0,0,0.45
Vision,867352992870558,2024-02-22,2024-02-22 06:00:00,QQQ240222C0039000,QQQ,1.25,1.25,3.43,7766.0,375.0,-375,7391.0,0.0,0.0,5,3,0.0,0,0.0,0.0,0,0.0,0,1.43
Base,150220500239085,2024-02-23,2024-02-23 01:00:00,MCD240223C0045400,MCD,1.89,1.89,2.78,7391.0,378.0,565,7956.0,0.0,0.0,5,2,2.46,1,2.46,3.21,1,0.0,1,2.46
Base,202159273984766,2024-02-26,2024-02-26 05:00:00,SPY240105C0036700,SPY,0.9,0.9,1.6,7956.0,360.0,444,8400.0,0.0,0.0,5,4,1.17,2,1.17,1.53,2,1.53,2,1.53
Base,893796276326817,2024-02-27,2024-02-27 07:00:00,SPY240109C0058400,SPY,1.13,1.13,1.9,8400.0,339.0,558,8958.0,0.0,0.0,5,3,1.47,2,1.47,1.92,1,0.0,1,1.47
Lotto,924832410623269,2024-02-28,2024-02-28 02:00:00,HPQ240228P0048700,HPQ,0.34,0.34,0.45,8958.0,374.0,476,9434.0,0.0,0.0,5,11,0.58,6,0.0,0.0,0,0.0,0,0.0
Lotto,435333620001556,2024-02-29,2024-02-29 04:00:00,SPX240229C0038100,SPX,0.7,0.7,1.88,9434.0,420.0,431,9865.0,0.0,0.0,5,6,1.19,3,1.19,0.0,0,0.0,1,1.19
Base,947083982689503,2024-03-01,2024-03-01 01:00:00,AXP240301P0037400,AXP,1.26,1.26,2.99,9865.0,378.0,664,10529.0,0.0,0.0,5,3,1.64,2,1.64,2.14,1,2.14,2,2.14
Vision,922124527598042,2024-03-04,2024-03-04 01:00:00,SPY240122C0030700,SPY,1.56,1.56,4.33,10529.0,468.0,-468,10061.0,0.0,0.0,5,3,0.0,0,0.0,0.0,0,0.0,0,3.99
Base,122320961988884,2024-03-05,2024-03-05 03:00:00,IWM240305P0037200,IWM,1.01,1.01,1.41,10061.0,404.0,540,10601.0,0.0,0.0,5,4,1.31,2,1.31,1.72,2,0.0,1,1.31
Lotto,563391466377488,2024-03-06,2024-03-06 05:00:00,NKE240306C0049200,NKE,1.75,1.75,3.65,10601.0,525.0,564,11165.0,0.0,0.0,5,3,2.98,2,2.98,0.0,0,0.0,1,2.98
Vision,238349837736848,2024-03-07,2024-03-07 01:00:00,QQQ240307C0032700,QQQ,1.91,1.91,3.02,11165.0,382.0,573,11738.0,0.0,0.0,5,2,0.0,0,0.0,0.0,0,0.0,0,4.6
Vision,951066506864802,2024-03-08,2024-03-08 04:00:00,SPY240206P0048700,SPY,0.28,0.28,0.69,11738.0,504.0,971,12709.0,0.0,0.0,5,18,0.0,0,0.0,0.0,0,0.0,0,0.31
Lotto,381686917791551,2024-03-11,2024-03-11 06:00:00,NKE240311P0050700,NKE,1.19,1.19,1.57,12709.0,476.0,-476,12233.0,0.0,0.0,5,4,2.02,2,0.0,0.0,0,0.0,0,0.0
Lotto,554054906902714,2024-03-12,2024-03-12 06:00:00,AMD240312C0041000,AMD,1.9,1.9,5.49,12233.0,570.0,-570,11663.0,0.0,0.0,5,3,3.23,2,3.23,0.0,0,0.0,1,3.23
Vision,458564322535736,2024-03-13,2024-03-13 03:00:00,QQQ240313C0056500,QQQ,0.92,0.92,1.25,11663.0,460.0,671,12334.0,0.0,0.0,5,5,0.0,0,0.0,0.0,0,0.0,0,-0.41
Vision,882583775776606,2024-03-14,2024-03-14 06:00:00,IWM240314P0033100,IWM,0.32,0.32,0.92,12334.0,512.0,-512,11822.0,0.0,0.0,5,16,0.0,0,0.0,0.0,0,0.0,0,0.05
Lotto,141371750719049,2024-03-15,2024-03-15 07:00:00,SPY240221C0047100,SPY,1.42,1.42,4.15,11822.0,426.0,798,12620.0,0.0,0.0,5,3,2.41,2,2.41,0.0,0,0.0,1,2.41
Vision,422801323017919,2024-03-18,2024-03-18 06:00:00,HPQ240318C0055200,HPQ,1.06,1.06,1.4,12620.0,530.0,677,13297.0,0.0,0.0,5,5,0.0,0,0.0,0.0,0,0.0,0,2.51
Base,558490110519581,2024-03-19,2024-03-19 03:00:00,AXP240319P0046700,AXP,0.19,0.19,0.41,13297.0,551.0,-551,12746.0,0.0,0.0,5,29,0.25,15,0.25,0.32,14,0.32,2,0.32
Vision,797189778503373,2024-03-20,2024-03-20 06:00:00,SPY240303C0046200,SPY,1.59,1.59,1.67,12746.0,477.0,863,13609.0,0.0,0.0,5,3,0.0,0,0.0,0.0,0,0.0,0,1.64
Base,132449760259507,2024-03-21,2024-03-21 01:00:00,QQQ240321C0053700,QQQ,0.92,0.92,1.81,13609.0,552.0,616,14225.0,0.0,0.0,5,6,1.2,3,1.2,1.56,3,1.56,2,1.56
Base,141065471456736,2024-03-22,2024-03-22 06:00:00,SPY240309P0042500,SPY,1.25,1.25,2.51,14225.0,625.0,-625,13600.0,0.0,0.0,5,5,1.62,3,1.62,2.12,2,2.12,2,2.12
Lotto,153909664732749,2024-03-25,2024-03-25 07:00:00,SPY240325C0051700,SPY,1.0,1.0,1.81,13600.0,600.0,1152,14752.0,0.0,0.0,5,6,1.7,3,1.7,0.0,0,0.0,1,1.7
Base,269631801276555,2024-03-26,2024-03-26 02:00:00,WMT240326C0048300,WMT,1.15,1.15,3.09,14752.0,575.0,942,15694.0,0.0,0.0,5,5,1.49,3,1.49,1.95,2,1.95,2,1.95
Vision,103536084459669,2024-03-27,2024-03-27 04:00:00,SPY240318C0054800,SPY,1.26,1.26,3.41,15694.0,630.0,-630,15064.0,0.0,0.0,5,5,0.0,0,0.0,0.0,0,0.0,0,3.35
Vision,428525005603684,2024-03-28,2024-03-28 07:00:00,SPY240321C0049700,SPY,0.45,0.45,0.98,15064.0,630.0,663,15727.0,0.0,0.0,5,14,0.0,0,0.0,0.0,0,0.0,0,1.21
Base,814145018455738,2024-03-29,2024-03-29 03:00:00,WMT240329P0041600,WMT,1.52,1.52,1.62,15727.0,608.0,823,16550.0,0.0,0.0,5,4,1.98,2,0.0,2.58,2,0.0,0,0.0
Vision,851517149536450,2024-04-01,2024-04-01 07:00:00,NKE240401C0048600,NKE,1.62,1.62,4.62,16550.0,648.0,1172,17722.0,0.0,0.0,5,4,0.0,0,0.0,0.0,0,0.0,0,3.03
Vision,567090214155530,2024-04-02,2024-04-02 06:00:00,XOM240402C0052800,XOM,0.26,0.26,0.27,17722.0,754.0,1347,19069.0,0.0,0.0,5,29,0.0,0,0.0,0.0,0,0.0,0,0.17
Vision,276124456954972,2024-04-03,2024-04-03 05:00:00,AXP240403C0059100,AXP,1.92,1.92,5.1,19069.0,768.0,811,19880.0,0.0,0.0,5,4,0.0,0,0.0,0.0,0,0.0,0,3.58
Vision,384078764189218,2024-04-04,2024-04-04 07:00:00,QQQ240404C0057300,QQQ,1.66,1.66,3.46,19880.0,830.0,1217,21097.0,0.0,0.0,5,5,0.0,0,0.0,0.0,0,0.0,0,2.17
Base,818294534428935,2024-04-05,2024-04-05 03:00:00,NKE240405P0032200,NKE,0.16,0.16,0.43,21097.0,880.0,1609,22706.0,0.0,0.0,5,55,0.21,28,0.21,0.27,27,0.27,2,0.27
Lotto,235247238349880,2024-04-08,2024-04-08 05:00:00,SPY240406C0052900,SPY,1.47,1.47,2.21,22706.0,882.0,1108,23814.0,0.0,0.0,5,6,2.5,3,0.0,0.0,0,0.0,0,0.0
Base,729154111125114,2024-04-09,2024-04-09 01:00:00,SPY240409C0035100,SPY,0.51,0.51,0.99,23814.0,1020.0,1899,25713.0,0.0,0.0,5,20,0.66,10,0.66,0.87,10,0.87,2,0.87
Vision,709666323129296,2024-04-10,2024-04-10 06:00:00,SPY240410C0058300,SPY,0.22,0.22,0.57,25713.0,1078.0,-1078,24635.0,0.0,0.0,5,49,0.0,0,0.0,0.0,0,0.0,0,-0.02
Vision,820674048469104,2024-04-11,2024-04-11 04:00:00,QQQ240411C0032600,QQQ,0.55,0.55,0.86,24635.0,1045.0,1638,26273.0,0.0,0.0,5,19,0.0,0,0.0,0.0,0,0.0,0,0.69
Vision,616738170679749,2024-04-12,2024-04-12 04:00:00,HPQ240412P0034200,HPQ,0.93,0.93,1.44,26273.0,1116.0,-1116,25157.0,0.0,0.0,5,12,0.0,0,0.0,0.0,0,0.0,0,0.23
Vision,269041185652082,2024-04-15,2024-04-15 05:00:00,AMD240415C0032600,AMD,0.33,0.33,0.55,25157.0,1056.0,2019,27176.0,0.0,0.0,5,32,0.0,0,0.0,0.0,0,0.0,0,0.47
Lotto,326058849532361,2024-04-16,2024-04-16 04:00:00,NKE240416C0038300,NKE,0.33,0.33,0.93,27176.0,1155.0,-1155,26021.0,0.0,0.0,5,35,0.56,18,0.56,0.0,0,0.0,1,0.56
Lotto,383114996114460,2024-04-17,2024-04-17 07:00:00,SPY240424P0059600,SPY,1.38,1.38,3.02,26021.0,1104.0,1635,27656.0,0.0,0.0,5,8,2.35,4,2.35,0.0,0,0.0,1,2.35
Lotto,325687548990005,2024-04-18,2024-04-18 06:00:00,SPY240427P0035200,SPY,1.13,1.13,3.15,27656.0,1130.0,1191,28847.0,0.0,0.0,5,10,1.92,5,1.92,0.0,0,0.0,1,1.92
Base,844908918959595,2024-04-19,2024-04-19 02:00:00,SPY240501P0037800,SPY,0.1,0.1,0.15,28847.0,1210.0,2417,31264.0,0.0,0.0,5,121,0.13,61,0.13,0.17,60,0.0,1,0.13
Lotto,815560595327714,2024-04-22,2024-04-22 02:00:00,SPY240503C0045900,SPY,1.75,1.75,4.84,31264.0,1400.0,2109,33373.0,0.0,0.0,5,8,2.98,4,2.98,0.0,0,0.0,1,2.98
Base,362410676058085,2024-04-23,2024-04-23 03:00:00,SPY240506C0049900,SPY,0.8,0.8,2.03,33373.0,1440.0,2463,35836.0,0.0,0.0,5,18,1.04,9,1.04,1.36,9,1.36,2,1.36
Lotto,896385896072092,2024-04-24,2024-04-24 06:00:00,IWM240424C0037700,IWM,1.98,1.98,5.59,35836.0,1584.0,2845,38681.0,0.0,0.0,5,8,3.37,4,3.37,0.0,0,0.0,1,3.37
Vision,795944908807316,2024-04-25,2024-04-25 02:00:00,IWM240425C0051700,IWM,1.35,1.35,2.19,38681.0,1620.0,2890,41571.0,0.0,0.0,5,12,0.0,0,0.0,0.0,0,0.0,0,2.0
Vision,622945897265468,2024-04-26,2024-04-26 05:00:00,NKE240426C0032000,NKE,0.98,0.98,2.72,41571.0,1764.0,2003,43574.0,0.0,0.0,5,18,0.0,0,0.0,0.0,0,0.0,0,0.95
Lotto,195051518151701,2024-04-29,2024-04-29 04:00:00,SPY240516P0031400,SPY,1.55,1.55,3.65,43574.0,1860.0,2755,46329.0,0.0,0.0,5,12,2.63,6,2.63,0.0,0,0.0,1,2.63
Lotto,433865652056703,2024-04-30,2024-04-30 04:00:00,MCD240430P0059200,MCD,1.28,1.28,2.66,46329.0,1920.0,3169,49498.0,0.0,0.0,5,15,2.18,8,2.18,0.0,0,0.0,1,2.18
Vision,462504496052999,2024-05-01,2024-05-01 07:00:00,SPY240501P0031200,SPY,1.74,1.74,2.66,49498.0,2088.0,2607,52105.0,0.0,0.0,5,12,0.0,0,0.0,0.0,0,0.0,0,1.26
Base,888335728803618,2024-05-02,2024-05-02 02:00:00,WMT240502P0055000,WMT,0.69,0.69,1.99,52105.0,2208.0,4137,56242.0,0.0,0.0,5,32,0.9,16,0.9,1.17,16,1.17,2,1.17
Base,739439682232442,2024-05-03,2024-05-03 04:00:00,AMD240503C0048800,AMD,1.57,1.57,2.83,56242.0,2355.0,3467,59709.0,0.0,0.0,5,15,2.04,8,2.04,2.67,7,2.67,2,2.67
Lotto,962759052024495,2024-05-06,2024-05-06 04:00:00,SPY240529C0042700,SPY,1.01,1.01,1.04,59709.0,2525.0,2646,62355.0,0.0,0.0,5,25,1.72,13,0.0,0.0,0,0.0,0,0.0
Vision,596478727374713,2024-05-07,2024-05-07 01:00:00,LUV240507C0042700,LUV,1.06,1.06,1.82,62355.0,2650.0,-2650,59705.0,0.0,0.0,5,25,0.0,0,0.0,0.0,0,0.0,0,0.22
Base,268647506532995,2024-05-08,2024-05-08 02:00:00,SPX240508P0059800,SPX,0.82,0.82,1.25,59705.0,2542.0,-2542,57163.0,0.0,0.0,5,31,1.07,16,1.07,1.39,15,0.0,1,1.07
Base,895855868037566,2024-05-09,2024-05-09 05:00:00,SPY240609C0054600,SPY,1.27,1.27,2.96,57163.0,2413.0,3683,60846.0,0.0,0.0,5,19,1.65,10,1.65,2.16,9,2.16,2,2.16
Vision,878780278149119,2024-05-10,2024-05-10 05:00:00,SPY240613P0058000,SPY,1.52,1.52,3.45,60846.0,2584.0,-2584,58262.0,0.0,0.0,5,17,0.0,0,0.0,0.0,0,0.0,0,-0.33
Vision,455704624791652,2024-05-13,2024-05-13 03:00:00,BAC240513C0031200,BAC,0.88,0.88,2.27,58262.0,2464.0,-2464,55798.0,0.0,0.0,5,28,0.0,0,0.0,0.0,0,0.0,0,1.54
Base,846745471719952,2024-05-14,2024-05-14 05:00:00,SPY240620C0044700,SPY,0.63,0.63,1.5,55798.0,2331.0,2988,58786.0,0.0,0.0,5,37,0.82,19,0.82,1.07,18,1.07,2,1.07
Base,897201712983438,2024-05-15,2024-05-15 06:00:00,SPY240625C0046500,SPY,0.99,0.99,1.27,58786.0,2475.0,3498,62284.0,0.0,0.0,5,25,1.29,13,0.0,1.68,12,0.0,0,0.0
Vision,314030204505428,2024-05-16,2024-05-16 06:00:00,AXP240516C0054700,AXP,1.68,1.68,3.71,62284.0,2688.0,-2688,59596.0,0.0,0.0,5,16,0.0,0,0.0,0.0,0,0.0,0,1.38
Vision,766835054341930,2024-05-17,2024-05-17 02:00:00,SPY240704C0037800,SPY,1.74,1.74,2.7,59596.0,2436.0,-2436,57160.0,0.0,0.0,5,14,0.0,0,0.0,0.0,0,0.0,0,0.85
Lotto,315122547347615,2024-05-20,2024-05-20 07:00:00,SPY240706P0032200,SPY,0.64,0.64,1.01,57160.0,2432.0,-2432,54728.0,0.0,0.0,5,38,1.09,19,0.0,0.0,0,0.0,0,0.0
Vision,466483061828793,2024-05-21,2024-05-21 03:00:00,MCD240521C0030000,MCD,1.41,1.41,2.75,54728.0,2256.0,3130,57858.0,0.0,0.0,5,16,0.0,0,0.0,0.0,0,0.0,0,2.08
Base,542351174852582,2024-05-22,2024-05-22 02:00:00,QQQ240522C0038800,QQQ,0.1,0.1,0.21,57858.0,2430.0,4369,62227.0,0.0,0.0,5,243,0.13,122,0.13,0.17,121,0.17,2,0.17
Base,541574235738692,2024-05-23,2024-05-23 02:00:00,SPY240717P0041000,SPY,1.19,1.19,1.73,62227.0,2618.0,-2618,59609.0,0.0,0.0,5,22,1.55,11,1.55,2.02,11,0.0,1,1.55
Vision,303389107898426,2024-05-24,2024-05-24 05:00:00,WMT240524C0033500,WMT,0.43,0.43,0.55,59609.0,2494.0,4479,64088.0,0.0,0.0,5,58,0.0,0,0.0,0.0,0,0.0,0,0.16
Base,682408066775157,2024-05-27,2024-05-27 01:00:00,AMD240527P0031200,AMD,0.71,0.71,1.63,64088.0,2698.0,3810,67898.0,0.0,0.0,5,38,0.92,19,0.92,1.21,19,1.21,2,1.21
Lotto,741133768001753,2024-05-28,2024-05-28 03:00:00,SPY240725P0039500,SPY,0.58,0.58,0.75,67898.0,2842.0,4125,72023.0,0.0,0.0,5,49,0.99,25,0.0,0.0,0,0.0,0,0.0
Vision,982126425535389,2024-05-29,2024-05-29 06:00:00,WMT240529C0034400,WMT,0.68,0.68,1.3,72023.0,2992.0,-2992,69031.0,0.0,0.0,5,44,0.0,0,0.0,0.0,0,0.0,0,0.92
Vision,294985941121555,2024-05-30,2024-05-30 06:00:00,AMD240530P0037600,AMD,0.57,0.57,0.84,69031.0,2907.0,5054,74085.0,0.0,0.0,5,51,0.0,0,0.0,0.0,0,0.0,0,1.43
Base,907922645332453,2024-05-31,2024-05-31 06:00:00,SPY240806C0055100,SPY,0.55,0.55,1.55,74085.0,3135.0,-3135,70950.0,0.0,0.0,5,57,0.72,29,0.72,0.94,28,0.94,2,0.94
Lotto,452555123011984,2024-06-03,2024-06-03 01:00:00,QQQ240603P0057600,QQQ,1.64,1.64,4.88,70950.0,2952.0,3778,74728.0,0.0,0.0,5,18,2.79,9,2.79,0.0,0,0.0,1,2.79
Vision,615650642818091,2024-06-04,2024-06-04 05:00:00,SPY240811P0055900,SPY,0.65,0.65,1.1,74728.0,3120.0,5391,80119.0,0.0,0.0,5,48,0.0,0,0.0,0.0,0,0.0,0,1.94
Vision,709185828893618,2024-06-05,2024-06-05 07:00:00,SPY240815C0031200,SPY,1.55,1.55,2.65,80119.0,3410.0,5350,85469.0,0.0,0.0,5,22,0.0,0,0.0,0.0,0,0.0,0,1.19
Lotto,909141238229771,2024-06-06,2024-06-06 04:00:00,LUV240606C0035100,LUV,1.87,1.87,3.23,85469.0,3553.0,6594,92063.0,0.0,0.0,5,19,3.18,10,3.18,0.0,0,0.0,1,3.18
Vision,326390627069696,2024-06-07,2024-06-07 04:00:00,SPY240825C0054000,SPY,0.81,0.81,2.35,92063.0,3888.0,4750,96813.0,0.0,0.0,5,48,0.0,0,0.0,0.0,0,0.0,0,2.34
Base,312300858933877,2024-06-10,2024-06-10 02:00:00,SPY240830P0058900,SPY,1.87,1.87,2.92,96813.0,4114.0,5465,102278.0,0.0,0.0,5,22,2.43,11,2.43,3.18,11,0.0,1,2.43
Lotto,126752421022029,2024-06-11,2024-06-11 06:00:00,SPY240831P0053500,SPY,1.95,1.95,2.63,102278.0,4290.0,7163,109441.0,0.0,0.0,5,22,3.31,11,0.0,0.0,0,0.0,0,0.0
Lotto,399997847950368,2024-06-12,2024-06-12 03:00:00,AMD240612C0055300,AMD,0.13,0.13,0.26,109441.0,4602.0,6488,115929.0,0.0,0.0,5,354,0.22,177,0.22,0.0,0,0.0,1,0.22
Base,735142036540861,2024-06-13,2024-06-13 04:00:00,SPY240908C0050000,SPY,0.8,0.8,1.39,115929.0,4880.0,5110,121039.0,0.0,0.0,5,61,1.04,31,1.04,1.36,30,1.36,2,1.36
Lotto,549917592242753,2024-06-14,2024-06-14 03:00:00,SPY240912P0038100,SPY,0.49,0.49,0.82,121039.0,5096.0,-5096,115943.0,0.0,0.0,5,104,0.83,52,0.0,0.0,0,0.0,0,0.0
Vision,611344768810253,2024-06-17,2024-06-17 02:00:00,SPY240914C0030200,SPY,0.36,0.36,0.63,115943.0,4860.0,7539,123482.0,0.0,0.0,5,135,0.0,0,0.0,0.0,0,0.0,0,0.17
Lotto,260328020920132,2024-06-18,2024-06-18 05:00:00,SPY240917C0036700,SPY,1.39,1.39,1.78,123482.0,5143.0,-5143,118339.0,0.0,0.0,5,37,2.36,19,0.0,0.0,0,0.0,0,0.0
Lotto,360864566002009,2024-06-19,2024-06-19 04:00:00,NKE240619C0058700,NKE,0.73,0.73,1.06,118339.0,4964.0,9209,127548.0,0.0,0.0,5,68,1.24,34,0.0,0.0,0,0.0,0,0.0
Vision,270719898594326,2024-06-20,2024-06-20 06:00:00,SPY240924P0033600,SPY,0.61,0.61,1.7,127548.0,5368.0,-5368,122180.0,0.0,0.0,5,88,0.0,0,0.0,0.0,0,0.0,0,1.59
Lotto,188223940055965,2024-06-21,2024-06-21 04:00:00,SPY240926P0045200,SPY,0.21,0.21,0.39,122180.0,5124.0,-5124,117056.0,0.0,0.0,5,244,0.36,122,0.36,0.0,0,0.0,1,0.36
Vision,195007534396341,2024-06-24,2024-06-24 06:00:00,QQQ240624C0044200,QQQ,0.15,0.15,0.35,117056.0,4920.0,-4920,112136.0,0.0,0.0,5,328,0.0,0,0.0,0.0,0,0.0,0,0.03
Base,701687142440053,2024-06-25,2024-06-25 04:00:00,SPY241003P0035500,SPY,0.4,0.4,1.13,112136.0,4720.0,5532,117668.0,0.0,0.0,5,118,0.52,59,0.52,0.68,59,0.68,2,0.68
Lotto,153246151275459,2024-06-26,2024-06-26 03:00:00,AMD240626C0037600,AMD,0.55,0.55,1.26,117668.0,4950.0,5107,122775.0,0.0,0.0,5,90,0.94,45,0.94,0.0,0,0.0,1,0.94
Vision,827426989046315,2024-06-27,2024-06-27 06:00:00,SPY241009P0035200,SPY,0.26,0.26,0.46,122775.0,5148.0,-5148,117627.0,0.0,0.0,5,198,0.0,0,0.0,0.0,0,0.0,0,0.19
Vision,807752291172520,2024-06-28,2024-06-28 01:00:00,NKE240628C0050200,NKE,1.5,1.5,3.54,117627.0,4950.0,6396,124023.0,0.0,0.0,5,33,0.0,0,0.0,0.0,0,0.0,0,-0.16
Base,190239385941787,2024-07-01,2024-07-01 04:00:00,XOM240701P0055900,XOM,0.62,0.62,1.37,124023.0,5208.0,7916,131939.0,0.0,0.0,5,84,0.81,42,0.81,1.05,42,1.05,2,1.05
Base,698784463187990,2024-07-02,2024-07-02 05:00:00,SPY241021P0056600,SPY,2.0,2.0,3.8,131939.0,5600.0,11095,143034.0,0.0,0.0,5,28,2.6,14,2.6,3.4,14,3.4,2,3.4
Lotto,945527015107347,2024-07-03,2024-07-03 01:00:00,MCD240703P0039500,MCD,0.73,0.73,1.54,143034.0,5986.0,9178,152212.0,0.0,0.0,5,82,1.24,41,1.24,0.0,0,0.0,1,1.24
Vision,460100091956653,2024-07-04,2024-07-04 02:00:00,SPY241028P0051400,SPY,1.79,1.79,3.54,152212.0,6444.0,-6444,145768.0,0.0,0.0,5,36,0.0,0,0.0,0.0,0,0.0,0,1.8
Vision,175343794787468,2024-07-05,2024-07-05 07:00:00,SPY241031P0046100,SPY,0.31,0.31,0.91,145768.0,6107.0,-6107,139661.0,0.0,0.0,5,197,0.0,0,0.0,0.0,0,0.0,0,0.03
Lotto,796121708805428,2024-07-08,2024-07-08 03:00:00,BAC240708P0032200,BAC,0.66,0.66,1.04,139661.0,5874.0,-5874,133787.0,0.0,0.0,5,89,1.12,45,0.0,0.0,0,0.0,0,0.0
Lotto,474727251404039,2024-07-09,2024-07-09 05:00:00,SPY241107P0054400,SPY,0.64,0.64,0.8,133787.0,5632.0,-5632,128155.0,0.0,0.0,5,88,1.09,44,0.0,0.0,0,0.0,0,0.0
Lotto,815573273237493,2024-07-10,2024-07-10 06:00:00,SPY241111P0053100,SPY,1.48,1.48,2.56,128155.0,5328.0,8127,136282.0,0.0,0.0,5,36,2.52,18,2.52,0.0,0,0.0,1,2.52
Vision,793169032493127,2024-07-11,2024-07-11 03:00:00,LUV240711C0053400,LUV,1.09,1.09,2.95,136282.0,5777.0,9178,145460.0,0.0,0.0,5,53,0.0,0,0.0,0.0,0,0.0,0,2.23
Vision,121074775544820,2024-07-12,2024-07-12 03:00:00,SPX240712P0050200,SPX,0.42,0.42,0.67,145460.0,6090.0,-6090,139370.0,0.0,0.0,5,145,0.0,0,0.0,0.0,0,0.0,0,0.91
Base,325638475438031,2024-07-15,2024-07-15 05:00:00,SPY241124P0041800,SPY,0.74,0.74,1.66,139370.0,5846.0,6048,145418.0,0.0,0.0,5,79,0.96,40,0.96,1.26,39,1.26,2,1.26
Lotto,736412740610837,2024-07-16,2024-07-16 02:00:00,SPY241127P0041900,SPY,1.63,1.63,3.17,145418.0,6031.0,8706,154124.0,0.0,0.0,5,37,2.77,19,2.77,0.0,0,0.0,1,2.77
Lotto,192170389642749,2024-07-17,2024-07-17 01:00:00,HPQ240717P0050400,HPQ,0.53,0.53,0.74,154124.0,6466.0,10417,164541.0,0.0,0.0,5,122,0.9,61,0.0,0.0,0,0.0,0,0.0
Vision,707257516523420,2024-07-18,2024-07-18 06:00:00,SPY241203C0044000,SPY,0.76,0.76,2.13,164541.0,6916.0,-6916,157625.0,0.0,0.0,5,91,0.0,0,0.0,0.0,0,0.0,0,0.45
Base,373615399096147,2024-07-19,2024-07-19 01:00:00,MCD240719P0051100,MCD,0.89,0.89,1.74,157625.0,6586.0,11560,169185.0,0.0,0.0,5,74,1.16,37,1.16,1.51,37,1.51,2,1.51
Lotto,215326500103131,2024-07-22,2024-07-22 02:00:00,SPY241207C0042900,SPY,1.34,1.34,3.27,169185.0,7102.0,12058,181243.0,0.0,0.0,5,53,2.28,27,2.28,0.0,0,0.0,1,2.28
Base,123107813489975,2024-07-23,2024-07-23 03:00:00,SPY241209C0041200,SPY,1.45,1.45,1.76,181243.0,7540.0,14678,195921.0,0.0,0.0,5,52,1.89,26,0.0,2.46,26,0.0,0,0.0
Base,240732700295820,2024-07-24,2024-07-24 06:00:00,SPY241211C0040600,SPY,1.41,1.41,2.17,195921.0,8178.0,-8178,187743.0,0.0,0.0,5,58,1.83,29,1.83,2.4,29,0.0,1,1.83
Base,348730019580718,2024-07-25,2024-07-25 06:00:00,SPY240725P0030500,SPY,1.68,1.68,1.76,187743.0,7896.0,14984,202727.0,0.0,0.0,5,47,2.18,24,0.0,2.86,23,0.0,0,0.0
Lotto,106732878265292,2024-07-26,2024-07-26 02:00:00,SPY241217P0047100,SPY,1.84,1.84,3.07,202727.0,8464.0,11773,214500.0,0.0,0.0,5,46,3.13,23,0.0,0.0,0,0.0,0,0.0
Vision,189845152314397,2024-07-29,2024-07-29 04:00:00,SPY241218P0032000,SPY,0.24,0.24,0.43,214500.0,9000.0,10287,224787.0,0.0,0.0,5,375,0.0,0,0.0,0.0,0,0.0,0,0.37
Vision,773573714811264,2024-07-30,2024-07-30 01:00:00,SPX240730C0031100,SPX,1.24,1.24,2.52,224787.0,9424.0,-9424,215363.0,0.0,0.0,5,76,0.0,0,0.0,0.0,0,0.0,0,2.81
Base,362405572868433,2024-07-31,2024-07-31 04:00:00,SPY241226P0053700,SPY,2.0,2.0,3.07,215363.0,9000.0,-9000,206363.0,0.0,0.0,5,45,2.6,23,2.6,3.4,22,0.0,1,2.6
Base,409169599863378,2024-08-01,2024-08-01 06:00:00,SPX240801P0037000,SPX,1.98,1.98,5.01,206363.0,8712.0,12999,219362.0,0.0,0.0,5,44,2.57,22,2.57,3.37,22,3.37,2,3.37
Vision,866637032598866,2024-08-02,2024-08-02 01:00:00,SPX240802C0059500,SPX,0.52,0.52,1.39,219362.0,9204.0,-9204,210158.0,0.0,0.0,5,177,0.0,0,0.0,0.0,0,0.0,0,0.17
Base,250495223563356,2024-08-05,2024-08-05 04:00:00,SPY250106C0058100,SPY,0.26,0.26,0.43,210158.0,8814.0,-8814,201344.0,0.0,0.0,5,339,0.34,170,0.34,0.44,169,0.0,1,0.34
Vision,931174734508615,2024-08-06,2024-08-06 01:00:00,SPY250111C0030600,SPY,1.65,1.65,3.7,201344.0,8415.0,-8415,192929.0,0.0,0.0,5,51,0.0,0,0.0,0.0,0,0.0,0,3.35
Vision,676405660705584,2024-08-07,2024-08-07 04:00:00,XOM240807C0030300,XOM,1.32,1.32,3.39,192929.0,8052.0,-8052,184877.0,0.0,0.0,5,61,0.0,0,0.0,0.0,0,0.0,0,2.21
Base,267519547554235,2024-08-08,2024-08-08 06:00:00,AXP240808P0043400,AXP,1.87,1.87,2.57,184877.0,7854.0,12449,197326.0,0.0,0.0,5,42,2.43,21,2.43,3.18,21,0.0,1,2.43
Lotto,180900467717436,2024-08-09,2024-08-09 07:00:00,QQQ240809C0051900,QQQ,1.3,1.3,3.15,197326.0,8320.0,11994,209320.0,0.0,0.0,5,64,2.21,32,2.21,0.0,0,0.0,1,2.21
Lotto,954070398578142,2024-08-12,2024-08-12 01:00:00,SPY240812P0059000,SPY,1.33,1.33,3.61,209320.0,8778.0,15216,224536.0,0.0,0.0,5,66,2.26,33,2.26,0.0,0,0.0,1,2.26
Lotto,256095661590736,2024-08-13,2024-08-13 05:00:00,NKE240813P0035500,NKE,0.65,0.65,1.76,224536.0,9425.0,16581,241117.0,0.0,0.0,5,145,1.1,73,1.1,0.0,0,0.0,1,1.1
Lotto,339306205811706,2024-08-14,2024-08-14 06:00:00,SPY250126P0035800,SPY,0.8,0.8,1.63,241117.0,10160.0,-10160,230957.0,0.0,0.0,5,127,1.36,64,1.36,0.0,0,0.0,1,1.36
Base,393563544441385,2024-08-15,2024-08-15 07:00:00,SPY250129P0059200,SPY,1.51,1.51,3.15,230957.0,9664.0,-9664,221293.0,0.0,0.0,5,64,1.96,32,1.96,2.57,32,2.57,2,2.57
Lotto,949689903802630,2024-08-16,2024-08-16 06:00:00,IWM240816C0050200,IWM,0.12,0.12,0.17,221293.0,9300.0,9363,230656.0,0.0,0.0,5,775,0.2,388,0.0,0.0,0,0.0,0,0.0
Base,509222233545409,2024-08-19,2024-08-19 03:00:00,AMD240819C0058000,AMD,0.44,0.44,1.11,230656.0,9680.0,16137,246793.0,0.0,0.0,5,220,0.57,110,0.57,0.75,110,0.75,2,0.75
Lotto,702646768583574,2024-08-20,2024-08-20 07:00:00,QQQ240820P0048500,QQQ,1.1,1.1,1.14,246793.0,10340.0,10486,257279.0,0.0,0.0,5,94,1.87,47,0.0,0.0,0,0.0,0,0.0
Base,633257470717801,2024-08-21,2024-08-21 05:00:00,WMT240821P0056000,WMT,1.68,1.68,3.75,257279.0,10752.0,21197,278476.0,0.0,0.0,5,64,2.18,32,2.18,2.86,32,2.86,2,2.86
Base,344673954986593,2024-08-22,2024-08-22 04:00:00,SPY250211P0038700,SPY,1.68,1.68,4.97,278476.0,11760.0,-11760,266716.0,0.0,0.0,5,70,2.18,35,2.18,2.86,35,2.86,2,2.86
Vision,827572976891561,2024-08-23,2024-08-23 05:00:00,SPY250215P0049700,SPY,0.91,0.91,1.58,266716.0,11193.0,-11193,255523.0,0.0,0.0,5,123,0.0,0,0.0,0.0,0,0.0,0,0.25
Base,308210065816650,2024-08-26,2024-08-26 01:00:00,SPY250220P0036500,SPY,0.35,0.35,0.72,255523.0,10745.0,16895,272418.0,0.0,0.0,5,307,0.45,154,0.45,0.59,153,0.59,2,0.59
Base,230125344181875,2024-08-27,2024-08-27 02:00:00,MCD240827C0044500,MCD,1.8,1.8,3.79,272418.0,11520.0,19980,292398.0,0.0,0.0,5,64,2.34,32,2.34,3.06,32,3.06,2,3.06
Vision,410755931657479,2024-08-28,2024-08-28 07:00:00,SPY250227C0055700,SPY,1.69,1.69,4.19,292398.0,12337.0,21763,314161.0,0.0,0.0,5,73,0.0,0,0.0,0.0,0,0.0,0,2.27
Vision,239635754561837,2024-08-29,2024-08-29 01:00:00,SPY250302P0034600,SPY,1.24,1.24,1.32,314161.0,13144.0,-13144,301017.0,0.0,0.0,5,106,0.0,0,0.0,0.0,0,0.0,0,3.24
Vision,809472631471779,2024-08-30,2024-08-30 01:00:00,AMD240830P0034400,AMD,0.88,0.88,2.01,301017.0,12672.0,22067,323084.0,0.0,0.0,5,144,0.0,0,0.0,0.0,0,0.0,0,-0.28
Vision,550272545037117,2024-09-02,2024-09-02 05:00:00,SPY250308C0037800,SPY,1.81,1.81,2.51,323084.0,13575.0,17786,340870.0,0.0,0.0,5,75,0.0,0,0.0,0.0,0,0.0,0,0.24
Lotto,284884231451920,2024-09-03,2024-09-03 03:00:00,QQQ240903P0045300,QQQ,0.46,0.46,0.68,340870.0,14306.0,-14306,326564.0,0.0,0.0,5,311,0.78,156,0.0,0.0,0,0.0,0,0.0
Base,516491440562863,2024-09-04,2024-09-04 05:00:00,SPY250311P0052200,SPY,1.88,1.88,5.49,326564.0,13724.0,16585,343149.0,0.0,0.0,5,73,2.44,37,2.44,3.2,36,3.2,2,3.2
Vision,370181191043499,2024-09-05,2024-09-05 06:00:00,SPY250314P0043800,SPY,1.02,1.02,2.06,343149.0,14382.0,-14382,328767.0,0.0,0.0,5,141,0.0,0,0.0,0.0,0,0.0,0,-0.12
Lotto,817977892590032,2024-09-06,2024-09-06 03:00:00,AMD240906C0049900,AMD,0.73,0.73,2.14,328767.0,13797.0,-13797,314970.0,0.0,0.0,5,189,1.24,95,1.24,0.0,0,0.0,1,1.24
Lotto,895076974493721,2024-09-09,2024-09-09 02:00:00,MCD240909C0039800,MCD,0.11,0.11,0.23,314970.0,13233.0,20251,335221.0,0.0,0.0,5,1203,0.19,602,0.19,0.0,0,0.0,1,0.19
Vision,136875351364720,2024-09-10,2024-09-10 03:00:00,SPY250329C0049600,SPY,1.13,1.13,1.43,335221.0,14125.0,19537,354758.0,0.0,0.0,5,125,0.0,0,0.0,0.0,0,0.0,0,2.03
Base,450987814940919,2024-09-11,2024-09-11 03:00:00,SPY250401C0035800,SPY,0.98,0.98,1.04,354758.0,14896.0,18129,372887.0,0.0,0.0,5,152,1.27,76,0.0,1.67,76,0.0,0,0.0
Lotto,366332639943829,2024-09-12,2024-09-12 01:00:00,AXP240912C0035200,AXP,0.48,0.48,0.54,372887.0,15648.0,16680,389567.0,0.0,0.0,5,326,0.82,163,0.0,0.0,0,0.0,0,0.0
Base,765887255529776,2024-09-13,2024-09-13 01:00:00,SPY250407P0057200,SPY,1.21,1.21,3.49,389567.0,16335.0,18420,407987.0,0.0,0.0,5,135,1.57,68,1.57,2.06,67,2.06,2,2.06
Lotto,626832810851644,2024-09-16,2024-09-16 07:00:00,SPY250411P0030500,SPY,1.33,1.33,3.98,407987.0,17157.0,-17157,390830.0,0.0,0.0,5,129,2.26,65,2.26,0.0,0,0.0,1,2.26
Vision,357673719312900,2024-09-17,2024-09-17 06:00:00,SPY250416P0054000,SPY,0.52,0.52,0.72,390830.0,16432.0,-16432,374398.0,0.0,0.0,5,316,0.0,0,0.0,0.0,0,0.0,0,1.48
Vision,877196204341783,2024-09-18,2024-09-18 03:00:00,HPQ240918C0034300,HPQ,1.16,1.16,2.76,374398.0,15776.0,28479,402877.0,0.0,0.0,5,136,0.0,0,0.0,0.0,0,0.0,0,2.89
Lotto,591674816361521,2024-09-19,2024-09-19 03:00:00,AMD240919C0038700,AMD,0.69,0.69,1.49,402877.0,16905.0,25898,428775.0,0.0,0.0,5,245,1.17,123,1.17,0.0,0,0.0,1,1.17
Lotto,781187905922190,2024-09-20,2024-09-20 04:00:00,SPY250421C0058500,SPY,1.19,1.19,2.33,428775.0,17969.0,30903,459678.0,0.0,0.0,5,151,2.02,76,2.02,0.0,0,0.0,1,2.02
Base,526571491617856,2024-09-23,2024-09-23 05:00:00,SPY250423P0039500,SPY,1.77,1.77,2.54,459678.0,19293.0,24793,484471.0,0.0,0.0,5,109,2.3,55,2.3,3.01,54,0.0,1,2.3
Lotto,187994222477624,2024-09-24,2024-09-24 06:00:00,SPY250424C0053900,SPY,1.57,1.57,2.49,484471.0,20410.0,-20410,464061.0,0.0,0.0,5,130,2.67,65,0.0,0.0,0,0.0,0,0.0
Lotto,714902084094615,2024-09-25,2024-09-25 05:00:00,LUV240925C0037500,LUV,1.77,1.77,3.68,464061.0,19470.0,-19470,444591.0,0.0,0.0,5,110,3.01,55,3.01,0.0,0,0.0,1,3.01
Base,445865889722430,2024-09-26,2024-09-26 06:00:00,WMT240926P0041700,WMT,0.74,0.74,2.05,444591.0,18648.0,-18648,425943.0,0.0,0.0,5,252,0.96,126,0.96,1.26,126,1.26,2,1.26
Vision,479809153083808,2024-09-27,2024-09-27 07:00:00,SPX240927C0033000,SPX,1.15,1.15,3.01,425943.0,17940.0,32900,458843.0,0.0,0.0,5,156,0.0,0,0.0,0.0,0,0.0,0,3.28
Vision,391614077539035,2024-09-30,2024-09-30 03:00:00,AMD240930C0032300,AMD,1.11,1.11,1.74,458843.0,19314.0,-19314,439529.0,0.0,0.0,5,174,0.0,0,0.0,0.0,0,0.0,0,2.65
Vision,414659784605739,2024-10-01,2024-10-01 04:00:00,BAC241001C0033900,BAC,1.74,1.74,2.97,439529.0,18444.0,-18444,421085.0,0.0,0.0,5,106,0.0,0,0.0,0.0,0,0.0,0,0.18
Base,745228189335992,2024-10-02,2024-10-02 07:00:00,AXP241002P0037000,AXP,0.66,0.66,1.93,421085.0,17688.0,21584,442669.0,0.0,0.0,5,268,0.86,134,0.86,1.12,134,1.12,2,1.12
Base,910047067704361,2024-10-03,2024-10-03 05:00:00,SPX241003P0043400,SPX,0.97,0.97,1.18,442669.0,18624.0,21636,464305.0,0.0,0.0,5,192,1.26,96,0.0,1.65,96,0.0,0,0.0
Base,652051975236216,2024-10-04,2024-10-04 04:00:00,SPY250518C0050800,SPY,0.11,0.11,0.14,464305.0,19503.0,36089,500394.0,0.0,0.0,5,1773,0.14,887,0.14,0.19,886,0.0,1,0.14
Base,928747402630360,2024-10-07,2024-10-07 04:00:00,SPY250522C0046900,SPY,0.69,0.69,1.59,500394.0,21045.0,36305,536699.0,0.0,0.0,5,305,0.9,153,0.9,1.17,152,1.17,2,1.17
Base,849461297326797,2024-10-08,2024-10-08 06:00:00,LUV241008P0055300,LUV,1.92,1.92,3.59,536699.0,22464.0,36330,573029.0,0.0,0.0,5,117,2.5,59,2.5,3.26,58,3.26,2,3.26
Base,483712077034026,2024-10-09,2024-10-09 07:00:00,SPY241009P0030700,SPY,0.83,0.83,0.85,573029.0,24070.0,43864,616893.0,0.0,0.0,5,290,1.08,145,0.0,1.41,145,0.0,0,0.0
Base,705439704126288,2024-10-10,2024-10-10 03:00:00,SPY250602C0044600,SPY,2.0,2.0,5.23,616893.0,26000.0,47345,664238.0,0.0,0.0,5,130,2.6,65,2.6,3.4,65,3.4,2,3.4
Base,600887281906182,2024-10-11,2024-10-11 02:00:00,MCD241011C0034700,MCD,1.84,1.84,4.91,664238.0,27968.0,39488,703726.0,0.0,0.0,5,152,2.39,76,2.39,3.13,76,3.13,2,3.13
Lotto,355277015624028,2024-10-14,2024-10-14 04:00:00,SPY250610C0042500,SPY,1.61,1.61,4.6,703726.0,29624.0,-29624,674102.0,0.0,0.0,5,184,2.74,92,2.74,0.0,0,0.0,1,2.74
Base,277181046241323,2024-10-15,2024-10-15 07:00:00,SPY250614C0039000,SPY,0.46,0.46,1.37,674102.0,28290.0,34004,708106.0,0.0,0.0,5,615,0.6,308,0.6,0.78,307,0.78,2,0.78
Vision,740519155116461,2024-10-16,2024-10-16 05:00:00,SPY250618P0037300,SPY,0.99,0.99,2.84,708106.0,29700.0,-29700,678406.0,0.0,0.0,5,300,0.0,0,0.0,0.0,0,0.0,0,1.57
Lotto,631285825972024,2024-10-17,2024-10-17 06:00:00,SPY250619P0051700,SPY,1.64,1.64,4.33,678406.0,28536.0,35991,714397.0,0.0,0.0,5,174,2.79,87,2.79,0.0,0,0.0,1,2.79
Base,403793299034111,2024-10-18,2024-10-18 02:00:00,SPX241018C0049200,SPX,0.52,0.52,1.33,714397.0,30004.0,-30004,684393.0,0.0,0.0,5,577,0.68,289,0.68,0.88,288,0.88,2,0.88
Base,263634087537481,2024-10-21,2024-10-21 02:00:00,QQQ241021P0047900,QQQ,1.37,1.37,3.68,684393.0,28770.0,48426,732819.0,0.0,0.0,5,210,1.78,105,1.78,2.33,105,2.33,2,2.33
Lotto,501791238681456,2024-10-22,2024-10-22 04:00:00,NKE241022P0030800,NKE,0.69,0.69,1.86,732819.0,30774.0,48030,780849.0,0.0,0.0,5,446,1.17,223,1.17,0.0,0,0.0,1,1.17
Vision,888435668753040,2024-10-23,2024-10-23 02:00:00,SPY250629P0053500,SPY,0.67,0.67,1.44,780849.0,32763.0,41754,822603.0,0.0,0.0,5,489,0.0,0,0.0,0.0,0,0.0,0,1.81
Lotto,625676537248718,2024-10-24,2024-10-24 04:00:00,SPY250701P0036700,SPY,1.17,1.17,1.75,822603.0,34515.0,45280,867883.0,0.0,0.0,5,295,1.99,148,0.0,0.0,0,0.0,0,0.0
Lotto,239549047369864,2024-10-25,2024-10-25 03:00:00,SPY250703C0035000,SPY,0.83,0.83,2.24,867883.0,36437.0,-36437,831446.0,0.0,0.0,5,439,1.41,220,1.41,0.0,0,0.0,1,1.41
Base,232644938352918,2024-10-28,2024-10-28 01:00:00,AXP241028C0042600,AXP,1.4,1.4,3.2,831446.0,34860.0,50199,881645.0,0.0,0.0,5,249,1.82,125,1.82,2.38,124,2.38,2,2.38
Vision,796888762604669,2024-10-29,2024-10-29 06:00:00,MCD241029C0056800,MCD,1.56,1.56,1.98,881645.0,36972.0,67887,949532.0,0.0,0.0,5,237,0.0,0,0.0,0.0,0,0.0,0,4.51
Base,708488164843957,2024-10-30,2024-10-30 06:00:00,SPY250711P0033600,SPY,1.23,1.23,3.08,949532.0,39852.0,61007,1010539.0,0.0,0.0,5,324,1.6,162,1.6,2.09,162,2.09,2,2.09
